19x19
1111111111111111111
1000001000001000001
1010111110111110101
1010000000000000101
1010101110111010101
1010100010100010101
1011111011101111101
1000100000000010001
1010101110111010101
0010001000001000100
1010101110111010101
1000100000000010001
1011111011101111101
1010100010100010101
1010101110111010101
1010000000000000101
1010111110111110101
1000001000001000001
1111111111111111111